 - - - - - - - - - - 
| * * * * | * * * * |
 * - - - * * - - - * 
| * * * * | * * * * |
 - * * - - - - - * - 
| | | * * * * * * * |
 * * - - - - - - * - 
| | * * * * * * | * |
 * - * - * - * - - * 
| * * | # * | | * | |
 * - * - - - * * * * 
| | | * * * * | | | |
 * * - - - - * * - * 
| * * * * * * * * * |
 - - - - - - - - - -  
-1